20 20
1000 1700
1 1 1 1 1 1 1 1 1 1 1 1 1 1 1 1 1 1 1 1
1 1 1 8 5 5 5 5 5 5 5 5 5 5 5 5 9 1 1 1
1 1 1 4 16 17 18 16 17 18 16 17 18 16 17 18 6 1 1 1
1 1 1 4 17 18 16 17 18 16 17 18 16 17 18 16 6 1 1 1
1 1 1 4 18 16 17 18 16 17 18 16 17 18 16 17 6 1 1 1
1 1 1 4 16 17 18 16 17 18 16 17 18 16 17 18 6 1 1 1
1 1 1 4 17 18 16 17 18 16 17 18 16 17 18 16 6 1 1 1
1 1 1 4 18 16 17 18 16 17 18 16 17 18 16 17 6 1 1 1
1 1 1 4 16 17 18 16 17 18 16 17 18 16 17 18 6 1 1 1
1 1 1 4 17 18 16 17 18 16 17 18 16 17 18 16 6 1 1 1
1 1 1 4 18 16 17 18 16 17 18 16 17 18 16 17 6 1 1 1
1 1 1 4 16 17 18 16 17 18 16 17 18 16 17 18 6 1 1 1
1 1 1 4 17 18 16 17 18 16 17 18 16 17 18 16 6 1 1 1
1 1 1 4 18 16 17 18 16 17 18 16 17 18 16 17 6 1 1 1
1 1 1 4 16 17 18 16 17 18 16 17 18 16 17 18 6 1 1 1
1 1 1 4 17 18 16 17 18 16 17 18 16 17 18 16 6 1 1 1
1 1 1 4 18 16 17 18 16 17 18 16 17 18 16 17 6 1 1 1
1 1 1 4 16 17 18 16 17 18 16 17 18 16 17 18 6 1 1 1
1 1 1 11 7 7 7 7 7 7 7 7 7 7 7 7 10 1 1 1
1 1 1 1 1 1 1 1 1 1 1 1 1 1 1 1 1 1 1 1