20 20
900 1480
1 1 1 1 1 1 1 1 1 1 1 1 1 1 1 1 1 1 1 1
1 1 1 1 1 1 1 1 1 1 1 1 1 1 1 1 1 1 1 1
1 1 1 1 1 1 1 1 1 1 1 1 1 1 1 1 1 1 1 1
1 1 8 5 5 5 5 5 5 5 5 5 5 5 5 5 5 9 1 1
1 1 4 3 2 2 2 2 2 2 2 2 2 2 2 2 2 6 1 1
1 1 4 2 2 2 2 2 2 2 2 2 2 2 2 2 2 6 1 1
1 1 4 2 2 2 2 2 2 2 2 2 2 2 3 3 2 6 1 1
1 1 4 2 2 2 2 2 2 2 2 2 2 2 2 2 2 6 1 1
1 1 4 2 2 2 2 2 2 2 2 2 2 2 2 2 2 6 1 1
1 1 4 2 2 2 2 3 3 3 2 2 2 2 2 2 2 6 1 1
1 1 4 2 2 2 2 2 2 2 2 2 2 2 2 2 2 6 1 1
1 1 4 2 2 2 2 2 2 2 2 2 2 2 2 2 2 6 1 1
1 1 4 2 2 2 2 2 2 2 2 2 2 2 2 3 3 6 1 1
1 1 4 2 2 2 2 2 2 2 2 2 2 2 2 2 2 6 1 1
1 1 4 2 2 2 2 2 2 2 2 2 2 2 2 2 2 6 1 1 
1 1 4 2 3 3 2 2 2 2 2 2 2 2 2 2 2 6 1 1
1 1 11 7 7 7 7 7 7 7 7 7 7 7 7 7 7 10 1 1
1 1 1 1 1 1 1 1 1 1 1 1 1 1 1 1 1 1 1 1 
1 1 1 1 1 1 1 1 1 1 1 1 1 1 1 1 1 1 1 1
1 1 1 1 1 1 1 1 1 1 1 1 1 1 1 1 1 1 1 1