20 20
935 205
1 1 1 1 1 1 1 1 1 1 1 1 1 1 1 1 1 1 1 1
1 1 1 1 1 8 5 5 5 5 5 5 5 5 9 1 1 1 1 1
1 1 1 1 1 4 19 19 19 19 19 19 19 19 6 1 1 1 1 1
1 1 1 1 1 4 19 19 19 19 19 19 19 19 6 1 1 1 1 1
1 1 1 1 1 4 19 19 19 19 19 19 19 19 6 1 1 1 1 1
1 1 1 1 1 4 19 19 19 19 19 19 19 19 6 1 1 1 1 1
1 8 5 5 5 14 19 19 19 19 19 19 19 19 15 5 5 5 9 1
1 4 2 2 2 2 19 19 19 19 19 19 19 19 2 2 3 2 6 1
1 4 2 3 2 2 19 19 19 19 19 19 19 19 2 2 2 2 6 1
1 11 7 7 7 13 19 19 19 19 19 19 19 19 12 7 7 7 10 1
1 1 1 1 1 4 19 19 19 19 19 19 19 19 6 1 1 1 1 1
1 1 1 1 1 4 19 19 19 19 19 19 19 19 6 1 1 1 1 1
1 1 1 1 1 4 19 19 19 19 19 19 19 19 6 1 1 1 1 1
1 1 1 1 1 4 19 19 19 19 19 19 19 19 6 1 1 1 1 1
1 1 1 1 1 11 7 7 13 2 2 12 7 7 10 1 1 1 1 1
1 1 1 1 1 1 1 1 4 2 2 6 1 1 1 1 1 1 1 1
1 1 1 1 1 1 1 1 4 2 3 6 1 1 1 1 1 1 1 1
1 1 1 1 1 1 1 1 4 2 2 6 1 1 1 1 1 1 1 1
1 1 1 1 1 1 1 1 11 7 7 10 1 1 1 1 1 1 1 1
1 1 1 1 1 1 1 1 1 1 1 1 1 1 1 1 1 1 1 1