20 20
300 205
1 1 1 1 1 1 1 1 1 1 1 1 1 1 1 1 1 1 1 1
1 1 8 5 5 5 5 5 5 5 5 5 5 5 9 1 1 1 1 1
1 1 4 2 2 2 2 2 2 2 2 2 2 2 6 1 1 1 1 1
1 1 4 2 2 2 2 2 2 2 2 2 3 2 6 1 1 1 1 1
1 1 4 2 2 2 2 3 3 2 2 2 2 2 6 1 1 1 1 1
1 1 11 7 7 7 7 13 2 2 2 2 2 2 6 1 1 1 1 1
1 1 1 1 1 1 1 4 2 2 2 2 2 2 6 1 1 1 1 1
1 1 1 1 1 1 1 4 2 2 2 2 2 2 6 1 1 1 1 1
1 1 1 1 1 1 1 4 2 2 2 2 2 3 6 1 1 1 1 1
1 1 1 1 1 1 1 4 2 2 2 2 2 3 6 1 1 1 1 1
1 1 1 1 1 1 1 4 2 2 2 2 2 3 6 1 1 1 1 1
1 1 1 1 1 1 1 4 2 2 2 2 2 2 6 1 1 1 1 1
1 1 1 1 1 1 1 4 2 2 2 2 2 2 6 1 1 1 1 1
1 1 1 1 1 1 1 4 2 2 2 2 2 2 15 5 5 5 9 1
1 1 1 1 1 1 1 4 2 2 2 2 2 2 3 2 2 2 6 1
1 1 1 1 1 1 1 4 2 2 2 2 2 2 2 2 2 2 6 1
1 1 1 1 1 1 1 4 2 3 3 3 2 2 2 2 2 2 6 1
1 1 1 1 1 1 1 11 7 7 7 7 7 7 7 7 7 7 10 1
1 1 1 1 1 1 1 1 1 1 1 1 1 1 1 1 1 1 1 1
1 1 1 1 1 1 1 1 1 1 1 1 1 1 1 1 1 1 1 1